32
24
0 0 0 0 0 0 0 0 0 0 0 0 0 0 0 0 0 0 0 0 0 0 0 0 0 0 0 0 0 0 0 0 
0 0 0 0 0 0 0 300 0 0 0 0 0 0 0 0 0 0 0 0 0 0 0 0 0 0 0 0 0 0 0 0 
0 0 0 0 0 0 204 0 0 0 0 0 0 0 0 0 0 0 0 0 0 0 0 301 0 0 0 0 0 0 0 0 
0 0 0 0 0 0 10 10 0 0 0 0 0 0 0 0 0 0 0 0 0 0 0 0 203 0 0 0 0 0 0 0 
0 0 0 0 0 100 11 11 3 3 3 3 3 3 3 3 3 3 3 3 3 3 3 10 10 200 0 0 0 0 0 0 
0 0 0 0 0 12 11 11 11 11 11 11 11 11 11 0 0 0 0 0 0 0 0 0 11 10 101 0 0 0 0 0 
0 0 0 0 0 0 0 0 0 0 0 0 0 11 0 0 0 0 0 0 0 0 0 0 201 11 10 0 0 0 0 0 
10 10 10 13 0 0 0 0 0 0 0 0 0 11 0 0 0 0 0 0 12 10 10 10 10 11 11 10 0 0 0 0 
0 0 0 0 0 12 10 10 10 10 0 0 200 11 10 10 13 0 0 0 0 0 0 0 0 0 0 11 10 13 0 0 
0 0 0 0 0 0 0 0 0 0 0 0 10 11 0 0 0 0 0 0 0 0 0 0 0 0 0 0 0 0 0 0 
0 0 0 0 0 0 0 0 0 0 200 10 11 200 0 0 0 0 0 0 0 0 0 0 0 0 0 0 0 0 12 10 
0 0 0 0 0 0 0 0 0 0 10 11 11 10 10 10 10 10 10 10 10 13 0 0 0 0 0 0 0 0 0 0 
0 0 0 0 0 0 0 0 0 10 11 0 0 0 0 0 0 0 0 0 0 0 0 0 0 0 0 0 0 0 0 0 
0 0 0 0 0 10 10 10 10 11 0 0 0 0 0 0 0 0 0 0 0 0 0 10 10 3 3 3 10 10 10 10 
0 0 0 0 10 11 0 0 0 0 0 0 0 0 0 0 0 0 0 0 0 0 0 11 0 0 0 0 0 0 0 0 
10 13 0 10 11 0 0 0 0 0 0 0 0 0 0 0 10 10 10 10 10 10 10 11 0 0 0 0 0 0 0 0 
0 0 0 11 0 0 0 0 0 0 0 0 0 0 12 10 11 0 0 0 0 0 0 0 0 0 0 0 0 0 0 0 
0 0 0 11 0 0 0 0 0 0 0 0 0 0 0 0 0 0 0 0 0 0 0 0 0 0 0 0 0 0 0 0 
0 0 12 11 10 0 0 0 0 0 0 12 10 13 0 0 0 0 0 0 0 0 0 0 0 0 0 0 0 0 0 0 
0 0 0 0 11 0 0 0 0 0 0 0 0 0 0 0 0 0 0 0 0 0 0 0 0 0 0 0 0 0 0 0 
0 0 0 0 11 10 10 10 10 13 0 0 0 0 0 0 0 0 0 0 0 0 0 0 0 0 0 0 0 0 0 0 
10 0 0 0 0 0 0 0 0 0 0 0 0 0 0 0 0 0 0 0 0 0 0 0 0 0 0 0 0 0 0 0 
11 10 0 0 0 0 0 0 0 0 0 0 0 0 0 0 0 0 0 0 0 0 0 0 0 0 0 0 0 0 0 202 
11 11 10 10 10 10 10 10 10 10 10 10 10 10 10 10 10 10 10 10 10 10 10 10 10 10 10 10 10 10 10 10 
8
Switch 6 12 17 2 6 13 10
Switch 10 14 3 23 12 10 8
Switch 6 12 10 11 9 17 8
Switch 10 14 11 23 6 0 10
Switch 10 14 2 19 14 0 18
Switch 6 12 13 8 12 10 13
Switch 10 14 7 18 22 25 4
Switch 6 12 6 8 19 0 3

Switch int switchType, int laserType, int laserSize, int state, int switchX,int switchY, int laserX, int laserY
Button int buttonOneType, int buttonTwoType, int laserType, int state, int buttonOneX, int buttonOneY, int buttonTwoX, int buttonTwoY, int laserX, int laserY
100 - buoy
101 - grill
200 - bronze coin
201 - silver coin
202 - gold coin
203 - Red diamond
204 - blue diamond
300 - red door
301 - blue door
