32
24
0 0 0 0 0 0 0 0 0 0 0 0 0 0 0 0 0 0 0 0 0 0 0 0 0 0 0 0 0 0 0 0 
0 0 0 0 0 0 0 0 0 0 0 0 0 0 0 0 0 0 0 0 0 0 0 0 0 0 0 0 0 0 0 200 
0 0 0 0 0 0 0 10 0 0 0 0 0 0 0 0 10 1 1 1 13 0 0 12 13 0 0 0 0 12 10 10 
0 0 0 0 0 0 0 0 10 0 0 0 0 0 0 10 0 0 0 0 0 0 0 11 11 10 10 13 0 0 11 11 
0 0 0 0 12 0 0 0 0 10 10 10 10 10 10 0 0 0 0 0 0 0 12 11 0 0 11 11 0 0 0 11 
0 0 12 10 11 13 0 0 0 0 0 0 0 0 11 0 0 0 0 0 0 12 11 0 0 0 0 11 13 0 0 11 
13 0 0 0 0 11 10 13 0 0 0 0 0 12 11 0 0 0 0 0 12 11 0 0 0 0 0 0 11 0 0 11 
11 0 0 0 0 0 0 11 10 13 0 0 0 11 0 0 0 0 12 10 11 0 0 0 0 0 0 0 11 0 0 11 
11 0 0 0 0 0 0 0 201 11 0 0 0 11 0 0 0 12 11 0 0 0 0 0 12 3 3 10 11 0 0 11 
11 10 10 13 0 0 0 0 12 0 0 0 0 11 200 0 0 0 11 13 0 0 0 12 11 0 0 0 0 0 0 11 
0 0 0 11 13 0 0 0 11 0 0 0 0 11 13 0 0 0 0 11 13 0 0 0 0 0 0 0 0 0 0 11 
0 0 0 0 0 0 0 12 0 0 0 0 0 0 11 13 0 0 0 0 11 13 0 0 0 10 0 12 10 0 0 11 
202 0 0 0 0 0 0 11 0 0 0 10 0 0 11 11 10 13 0 202 202 11 10 10 10 11 0 0 11 0 0 11 
13 0 0 0 0 0 12 0 0 0 12 11 13 0 0 0 11 11 13 2 2 11 0 0 0 0 0 0 11 10 10 11 
11 13 0 0 0 0 11 0 0 0 11 11 11 0 0 0 0 0 0 0 0 0 0 0 0 0 0 0 0 0 0 0 
0 0 0 0 0 0 11 0 0 12 11 0 11 13 0 0 0 0 0 0 0 0 0 12 10 10 10 13 0 0 0 0 
0 0 0 0 12 10 11 0 0 0 0 0 0 0 0 0 0 0 0 0 0 0 12 0 0 0 0 11 0 0 0 0 
0 0 0 0 11 11 11 0 0 0 0 0 0 0 0 0 0 12 0 0 10 13 0 0 0 0 0 11 13 0 0 0 
0 0 0 12 11 11 11 0 0 0 0 0 12 10 10 10 10 11 0 0 0 11 0 0 0 10 0 0 11 13 0 0 
0 0 0 11 11 11 11 0 201 10 0 201 11 11 11 11 11 11 10 13 0 204 203 12 10 11 13 0 11 11 13 0 
0 0 0 0 0 11 11 10 10 11 10 10 11 11 11 11 0 0 0 11 10 10 10 11 0 0 0 0 11 0 0 0 
10 13 0 0 0 0 0 0 0 0 0 0 0 0 0 0 0 0 0 0 0 0 11 0 301 0 300 0 0 0 0 0 
11 11 0 0 0 0 0 0 0 0 0 0 0 0 0 0 0 0 0 0 100 101 11 0 0 0 0 0 0 0 0 0 
11 11 10 10 10 10 10 10 10 10 10 10 10 10 10 10 10 10 10 10 10 10 10 10 10 10 10 10 10 10 10 10
3
Button 0 4 15 2 30 12 25 17 18 17
Switch 8 13 4 27 7 5 4
Button 4 0 15 5 9 14 13 14 7 18

Switch int switchType, int laserType, int laserSize, int state, int switchX, int switchY, int laserX, int laserY

Button int buttonType, int laserType, int buttonOneX, int buttonOneY, int buttonTwoX, int buttonTwoY, int laserX, int laserY

100 - buoy
101 - grill
200 - bronze coin
201 - silver coin
202 - gold coin
203 - Red diamond
204 - blue diamaond
300 - red door
301 - blue door