32
24
0 0 0 0 0 0 0 0 0 0 0 0 0 0 0 0 0 0 0 0 0 0 0 0 0 0 0 0 0 0 0 0 
0 0 0 0 0 0 0 0 0 0 0 0 0 0 0 100 101 0 0 0 0 0 0 0 0 0 0 0 0 0 0 0 
0 0 0 0 0 0 0 0 0 0 0 0 0 0 12 10 10 13 0 0 0 0 0 0 0 0 0 0 0 0 0 0 
0 0 0 0 0 0 0 0 0 0 0 0 0 1 0 0 0 0 2 0 0 0 0 0 0 0 0 0 0 0 0 0 
0 0 0 0 0 0 0 0 0 0 0 201 1 0 301 0 0 300 0 2 201 0 0 0 0 0 0 0 0 0 0 0 
0 0 0 0 0 0 0 0 0 0 0 1 0 0 0 0 0 0 0 0 2 0 0 0 0 0 0 0 0 0 0 0 
0 0 0 0 0 0 0 0 0 0 1 0 0 0 12 0 0 13 0 0 0 2 0 0 0 0 0 0 0 0 0 0 
0 0 0 0 0 0 0 0 0 1 0 0 0 0 11 0 0 11 0 0 0 0 2 0 0 0 0 0 0 0 0 0 
0 0 0 0 0 0 0 0 0 0 0 0 0 10 203 0 0 204 10 0 0 0 0 0 0 0 0 0 0 0 0 0 
0 0 0 0 0 0 0 0 0 0 0 0 10 0 0 0 0 0 0 10 0 0 0 0 0 0 0 0 0 0 0 0 
0 0 0 0 0 0 0 0 0 0 10 0 0 0 0 0 0 0 0 0 0 10 0 0 0 0 0 0 0 0 0 0 
0 0 0 0 0 0 0 10 0 0 0 0 0 0 2 0 0 1 0 0 0 0 0 0 10 0 0 0 0 0 0 0 
10 10 10 13 0 0 0 0 0 0 0 10 0 0 2 0 0 1 0 0 10 0 0 0 0 0 0 0 12 10 10 10 
0 0 0 0 0 0 0 0 0 0 0 0 10 0 2 0 0 1 0 10 0 0 0 0 0 0 0 0 0 0 0 0 
0 0 0 0 0 0 0 0 0 2 0 0 0 10 0 0 0 0 10 0 0 0 1 0 0 0 0 0 0 0 0 0 
0 0 0 0 0 0 0 0 0 11 0 0 0 0 0 0 0 0 0 0 0 0 11 0 0 0 0 0 0 0 0 0 
0 0 0 0 12 10 10 13 0 0 0 10 0 202 0 202 0 202 0 0 10 0 0 0 12 10 10 13 0 0 0 0 
0 200 0 0 0 0 0 0 0 0 0 0 0 202 0 202 0 202 0 0 0 0 0 0 0 0 0 0 0 0 200 0 
0 10 0 0 0 0 0 0 0 0 0 201 0 202 202 202 0 202 0 0 201 0 0 0 0 0 0 0 0 0 10 0 
0 0 0 0 0 0 0 0 0 0 0 10 0 202 0 202 0 202 0 0 10 0 0 0 0 0 0 0 0 0 0 0 
0 0 0 0 0 0 0 0 0 0 0 0 0 202 0 202 0 202 0 0 0 0 0 0 0 0 0 0 0 0 0 0 
0 0 0 12 10 10 13 0 0 10 0 0 0 10 0 0 0 0 12 0 0 0 10 0 0 12 10 10 13 0 0 0 
0 0 0 0 0 0 0 0 0 0 0 0 0 0 0 0 0 0 0 0 0 0 0 0 0 0 0 0 0 0 0 0 
0 0 0 0 0 0 0 0 0 0 0 0 0 0 0 0 0 0 0 0 0 0 0 0 0 0 0 0 0 0 0 0 
2
Switch 10 12 5 6 15 20 9
Switch 6 14 5 25 15 7 9

Switch int switchType, int laserType, int laserSize, int state, int switchX,int switchY, int laserX, int laserY
Button int buttonOneType, int buttonTwoType, int laserType, int buttonOneX, int buttonOneY, int buttonTwoX, int buttonTwoY, int laserX, int laserY
100 - buoy
101 - grill
200 - bronze coin
201 - silver coin
202 - gold coin
203 - Red diamond
204 - blue diamond
300 - red door
301 - blue door