32
24
0 0 0 0 0 0 0 0 0 0 0 0 0 0 0 0 0 0 0 0 10 0 0 0 0 0 0 0 0 0 0 0 
0 0 0 0 0 0 0 0 0 0 0 0 0 0 0 0 0 0 0 0 3 0 0 0 0 0 0 0 0 0 0 0 
13 0 0 0 0 0 0 0 0 10 3 3 3 3 10 0 0 0 0 0 11 0 0 0 0 0 0 0 0 0 0 0 
11 0 0 0 0 0 0 0 0 11 11 11 11 11 11 10 0 0 0 0 3 0 0 0 0 0 10 0 0 0 0 0 
11 0 0 0 0 0 0 0 0 11 11 11 0 0 0 0 10 0 0 0 11 0 0 0 0 12 11 0 0 0 0 0 
11 0 0 0 0 0 0 0 12 11 0 0 0 0 0 0 0 13 0 0 3 0 0 12 10 11 0 0 0 0 0 0 
11 0 0 0 0 0 12 10 11 200 0 0 0 0 0 0 0 0 0 10 11 0 0 0 11 0 0 0 0 0 0 0 
11 0 0 0 0 0 0 0 11 13 0 0 0 0 0 0 0 0 0 11 0 10 0 0 11 0 0 0 0 0 0 0 
0 10 201 0 0 0 0 0 0 11 10 10 13 0 0 0 0 0 10 0 0 0 0 0 11 0 0 0 0 0 0 0 
0 0 10 0 0 0 0 0 0 0 0 0 11 13 101 100 0 10 0 0 0 0 0 12 11 0 0 0 0 0 0 0 
0 0 0 10 0 0 202 0 202 0 0 0 0 0 12 10 13 0 0 0 0 0 0 11 0 0 0 0 0 0 0 0 
0 0 0 0 10 3 0 0 0 0 0 0 0 0 0 0 0 0 0 0 0 0 12 11 0 0 0 0 0 0 0 0 
0 0 0 0 0 11 3 0 202 0 0 0 0 0 0 0 0 0 0 0 0 12 11 0 0 0 0 0 0 0 0 0 
0 0 0 0 0 0 11 3 0 0 0 0 0 0 0 0 0 0 0 0 0 11 0 0 0 0 0 0 0 0 0 0 
0 0 0 0 0 0 0 11 3 0 0 0 0 0 0 0 203 0 0 10 0 11 3 3 3 3 3 3 3 0 0 0 
0 0 0 0 0 0 0 0 11 10 0 0 0 0 0 0 0 0 0 0 0 11 11 11 11 11 11 11 11 0 0 0 
0 0 0 0 0 0 0 0 0 0 0 0 0 0 0 0 0 0 0 0 0 11 0 0 0 0 0 0 0 0 0 0 
0 0 0 0 0 0 0 0 0 0 12 10 10 10 13 0 0 0 0 12 10 11 0 0 0 0 0 0 0 0 0 0 
0 0 0 0 0 0 0 0 0 0 0 0 0 0 11 3 0 0 3 11 0 0 0 0 0 0 0 0 0 0 0 0 
0 0 0 0 0 0 0 0 0 0 0 0 0 0 11 11 0 0 11 11 0 0 0 0 0 0 0 0 0 0 0 0 
0 0 0 0 0 0 0 0 0 0 0 0 0 0 0 0 0 12 11 0 0 0 0 0 0 0 0 0 0 0 0 0 
204 0 0 0 0 0 0 0 0 0 0 0 0 0 0 0 0 0 0 0 0 0 0 0 0 0 0 0 0 0 300 301 
0 0 0 0 0 0 0 0 0 0 0 0 0 0 0 0 0 0 0 0 0 0 0 0 0 0 0 0 0 0 0 0 
10 1 1 1 1 1 10 1 1 1 1 1 10 3 3 3 10 3 3 3 10 3 3 3 3 3 3 3 3 3 10 10 
1
Button 4 0 15 5 9 14 20 22 10 15

Switch int switchType, int laserType, int laserSize, int state, int switchX,int switchY, int laserX, int laserY
Button int buttonOneType, int buttonTwoType, int laserType, int laserSize, int buttonOneX, int buttonOneY, int buttonTwoX, int buttonTwoY, int laserX, int laserY
100 - buoy
101 - grill
200 - bronze coin
201 - silver coin
202 - gold coin
203 - Red diamond
204 - blue diamond
300 - red door
301 - blue door