32
24
200 0 0 0 0 0 0 0 0 0 0 0 10 10 10 10 10 10 10 10 0 0 0 0 0 0 0 0 0 0 0 200 
10 10 10 10 10 0 10 10 10 13 0 0 11 202 202 0 0 202 202 11 0 0 12 10 10 10 0 10 10 10 10 10 
204 11 11 11 0 0 0 0 0 11 0 0 11 13 202 0 0 202 12 11 0 0 11 0 0 0 0 0 11 11 11 203 
0 0 11 11 10 10 13 0 0 11 13 0 0 11 13 200 200 12 11 0 0 12 11 0 0 12 10 10 11 11 0 0 
0 0 0 0 0 0 0 0 0 0 11 12 0 201 11 10 10 11 201 0 12 11 0 0 0 0 0 0 0 0 0 0 
0 12 10 10 10 10 10 10 10 10 11 0 0 0 0 0 0 0 0 0 0 11 10 10 10 10 10 10 10 10 13 0 
0 0 0 0 0 0 0 0 0 0 11 0 0 0 0 0 0 0 0 0 0 11 0 0 0 0 0 0 0 0 0 0 
0 10 0 0 0 0 0 0 0 0 11 10 10 3 13 0 0 12 3 10 10 11 0 0 0 0 0 0 0 0 10 0 
10 11 10 13 0 0 0 10 0 0 201 11 0 0 11 0 0 11 0 0 11 201 0 0 10 0 0 0 12 10 11 10 
0 0 0 11 0 0 0 0 0 0 0 11 0 0 11 300 301 11 0 0 11 0 0 0 0 0 0 0 11 0 0 0 
0 0 0 11 13 0 0 0 0 0 12 11 0 101 11 0 0 11 100 0 11 13 0 0 0 0 0 12 11 0 0 0 
0 10 0 0 0 0 0 0 0 12 11 0 0 12 11 10 10 11 13 0 0 11 13 0 0 0 0 0 0 0 10 0 
0 202 10 0 0 0 12 10 10 11 11 13 0 0 0 11 11 0 0 0 12 11 11 10 10 13 0 0 0 10 202 0 
0 0 11 10 10 10 11 0 0 0 0 0 0 0 0 0 0 0 0 0 0 0 0 0 0 11 10 10 10 11 0 0 
13 0 11 0 0 0 0 0 0 0 0 0 12 10 10 10 10 10 10 13 0 0 0 0 0 0 0 0 0 11 0 12 
0 0 11 0 0 0 0 0 12 13 0 0 0 0 0 0 0 0 0 0 0 0 12 13 0 0 0 0 0 11 0 0 
0 0 11 0 0 202 0 0 0 0 0 0 0 0 0 201 201 0 0 0 0 0 0 0 0 0 202 0 0 11 0 0 
0 10 0 0 0 12 13 0 0 0 0 0 0 0 0 10 10 0 0 0 0 0 0 0 0 12 13 0 0 0 10 0 
0 0 0 0 0 0 0 0 0 0 0 0 0 0 12 11 11 13 0 0 0 0 0 0 0 0 0 0 0 0 0 0 
0 0 0 0 0 0 0 0 0 0 0 0 0 0 0 200 200 0 0 0 0 0 0 0 0 0 0 0 0 0 0 0 
13 0 0 0 0 0 0 0 0 0 0 0 0 12 10 10 10 10 13 0 0 0 0 0 0 0 0 0 0 0 0 12 
0 0 0 0 0 10 0 0 0 0 0 0 0 0 0 0 0 0 0 0 0 0 0 0 0 0 10 0 0 0 0 0 
0 0 0 0 0 0 0 0 12 13 0 0 0 0 0 0 0 0 0 0 0 0 12 13 0 0 0 0 0 0 0 0 
10 13 3 3 3 3 3 3 3 3 3 3 3 3 3 3 3 3 3 3 3 3 3 3 3 3 3 3 3 3 12 10 
3
Button 4 0 15 2 13 13 18 13 15 13
Switch 6 12 1 0 22 26 1
Switch 10 14 1 31 22 5 1

Switch int switchType, int laserType, int laserSize, int state, int switchX,int switchY, int laserX, int laserY
Button int buttonOneType, int buttonTwoType, int laserType, int buttonOneX, int buttonOneY, int buttonTwoX, int buttonTwoY, int laserX, int laserY
100 - buoy
101 - grill
200 - bronze coin
201 - silver coin
202 - gold coin
203 - Red diamond
204 - blue diamond
300 - red door
301 - blue door