32
24
10 10 10 10 10 10 10 10 10 10 10 10 10 10 10 10 10 10 10 10 10 10 10 10 10 10 10 10 10 10 10 10 
11 0 0 0 0 0 0 0 0 0 0 0 0 0 0 0 0 0 0 0 0 0 0 0 0 0 0 0 0 0 0 11 
11 0 0 0 0 0 0 0 0 0 0 0 0 0 0 12 10 13 0 0 0 0 0 12 13 0 0 0 0 0 0 11 
11 0 0 0 0 0 0 0 0 0 0 0 0 12 13 0 201 0 12 13 0 0 0 0 0 10 0 0 0 0 0 11 
11 0 0 0 0 0 0 0 0 0 0 12 13 0 0 0 0 0 0 0 10 0 0 0 0 11 0 0 0 0 0 11 
11 0 0 0 0 0 0 0 0 0 10 0 0 0 0 0 0 0 0 0 0 12 13 0 0 0 10 0 0 0 0 11 
11 0 0 0 0 0 0 3 3 3 0 0 0 12 10 3 3 13 0 0 0 0 11 0 0 0 202 3 0 0 0 11 
11 0 0 0 0 0 12 11 0 0 0 0 10 0 0 0 0 0 10 0 0 0 0 10 0 0 0 11 13 0 0 11 
11 0 0 0 0 0 11 202 0 0 0 10 0 0 0 0 0 0 0 10 0 0 0 0 10 0 0 11 0 0 0 11 
11 0 0 0 0 0 11 0 0 0 10 0 0 0 12 10 13 0 0 0 10 0 0 0 11 0 0 11 0 0 0 11 
11 201 0 0 0 10 203 0 0 10 0 0 0 10 0 0 0 10 0 0 0 10 0 0 11 0 0 0 10 0 12 11 
11 10 10 13 0 11 0 0 12 11 0 0 10 201 0 300 301 0 10 0 0 11 0 0 0 10 0 0 11 0 0 11 
11 0 0 0 0 11 0 0 0 11 0 0 11 0 0 0 0 0 11 0 0 11 0 0 204 11 0 0 11 0 0 11 
11 0 0 0 0 11 0 0 0 11 0 12 11 0 0 12 10 13 0 0 0 11 0 0 10 0 0 0 11 13 0 11 
11 0 0 0 12 11 13 0 0 11 0 0 11 0 0 0 0 0 0 0 10 0 0 0 11 0 0 0 11 0 0 11 
11 0 0 0 0 202 11 0 0 11 0 0 0 12 13 0 0 0 12 13 0 0 0 0 11 0 0 10 0 0 0 11 
11 0 0 0 0 0 11 0 0 0 10 0 0 0 0 12 10 13 0 0 0 0 0 10 0 0 0 11 0 0 12 11 
11 0 0 10 0 0 0 10 0 0 0 10 0 0 0 0 0 0 0 0 0 12 13 0 0 0 0 11 0 0 0 11 
11 0 0 0 0 0 0 11 0 0 0 11 10 13 0 0 0 0 0 12 13 0 0 0 0 0 0 11 13 0 0 11 
11 0 0 0 0 0 0 0 10 0 0 0 0 0 12 10 3 10 13 0 0 0 0 0 0 0 10 0 0 0 0 11 
11 13 0 0 0 0 0 0 11 0 0 0 0 0 0 0 0 0 0 0 0 0 0 0 0 10 0 0 0 0 12 11 
11 0 0 0 0 0 0 0 0 12 13 0 0 0 0 0 0 0 0 0 0 0 0 12 10 11 0 0 0 0 0 11 
11 0 0 0 0 0 0 0 0 0 100 12 10 10 13 0 200 200 0 12 10 10 13 101 0 0 0 0 0 0 0 11 
11 10 10 10 3 3 3 10 10 10 10 11 11 11 11 10 10 10 10 11 11 11 11 10 10 10 10 3 3 10 10 11  
3
Button 0 4 15 5 3 10 25 10 18 2
Button 4 0 15 2 6 13 21 9 6 11
Button 4 0 15 2 20 13 17 12 13 13

Switch int switchType, int laserType, int laserSize, int state, int switchX, int switchY, int laserX, int laserY

Button int buttonType, int laserType, int buttonOneX, int buttonOneY, int buttonTwoX, int buttonTwoY, int laserX, int laserY

100 - buoy
101 - grill
200 - bronze coin
201 - silver coin
202 - gold coin
203 - Red diamond
204 - blue diamaond
300 - red door
301 - blue door