32
24
10 10 10 10 10 10 10 10 10 10 10 10 10 10 10 10 10 10 10 10 10 10 10 10 10 10 10 10 10 10 10 10 
11 0 0 0 0 0 0 0 0 0 0 0 0 0 0 0 0 0 0 11 202 0 0 0 0 0 0 0 0 0 0 11 
11 101 0 0 0 0 0 0 0 0 0 0 0 0 0 12 13 0 0 11 0 0 0 0 12 10 10 10 13 0 0 11 
11 10 10 10 13 0 0 0 0 10 0 0 0 0 10 0 0 0 0 11 0 0 0 12 11 0 0 0 11 13 0 11 
11 0 0 0 0 10 0 0 0 201 0 0 0 10 0 0 0 0 12 11 0 0 10 0 0 0 0 0 0 0 0 11 
11 300 0 0 0 0 10 0 0 0 0 0 10 11 0 0 0 12 11 0 0 12 11 0 0 12 13 0 0 0 0 11 
11 0 0 0 0 0 0 12 2 2 2 13 0 0 10 0 0 0 0 0 0 11 0 0 0 0 0 12 13 0 0 11 
11 10 10 13 0 0 0 0 0 0 0 0 0 0 0 12 13 0 12 10 13 0 12 13 0 0 0 0 0 12 0 11 
11 0 0 11 10 13 0 0 0 0 0 201 0 0 0 0 0 10 0 0 0 0 0 0 12 10 13 0 0 11 0 11 
11 0 0 0 0 11 13 0 0 0 0 0 0 0 0 0 200 0 0 0 0 0 0 0 0 0 0 0 0 11 0 11 
11 0 0 0 0 0 11 0 0 12 2 2 2 13 0 0 0 0 0 12 2 2 2 13 0 0 10 0 0 0 203 11 
11 10 10 10 10 10 11 10 10 11 11 11 11 11 10 10 10 10 10 11 11 11 11 11 10 10 11 10 10 10 10 11 
11 11 11 11 11 11 11 11 11 11 11 11 11 11 11 11 11 11 11 11 11 11 11 11 11 11 11 11 11 11 11 11 
11 0 0 0 0 0 0 0 0 0 0 202 11 0 0 0 0 0 0 0 0 0 0 0 0 0 0 0 0 0 0 11 
11 0 0 12 10 10 10 13 0 0 0 0 11 0 0 12 13 0 0 0 0 0 0 0 0 0 0 0 0 0 100 11 
11 0 12 11 0 0 0 11 13 0 0 0 11 0 0 0 0 10 0 0 0 0 10 0 0 0 0 12 10 10 10 11 
11 0 0 0 0 0 0 0 0 10 0 0 11 13 0 0 0 0 10 0 0 0 201 0 0 0 10 0 0 0 0 11 
11 0 0 0 0 12 13 0 0 11 13 0 0 11 13 0 0 0 11 10 0 0 0 0 0 10 0 0 0 0 301 11 
11 0 0 12 13 0 0 0 0 0 11 0 0 0 0 0 0 10 0 0 12 1 1 1 13 0 0 0 0 0 0 11 
11 0 13 0 0 0 0 0 12 13 0 12 10 13 0 12 13 0 0 0 0 0 0 0 0 0 0 0 12 10 10 11 
11 0 11 0 0 12 10 13 0 0 0 0 0 0 10 0 0 0 0 0 201 0 0 0 0 0 12 10 11 0 0 11 
11 0 11 0 0 0 0 0 0 0 0 0 0 0 0 200 0 0 0 0 0 0 0 0 0 12 11 0 0 0 0 11 
11 204 0 0 0 10 0 0 12 1 1 1 13 0 0 0 0 0 12 1 1 1 13 0 0 11 0 0 0 0 0 11 
11 10 10 10 10 11 10 10 11 11 11 11 11 10 10 10 10 10 11 11 11 11 11 10 10 11 10 10 10 10 10 11 
4
Switch 10 14 1 9 2 1 19
Switch 6 12 1 22 14 30 7
Switch 6 12 3 15 22 27 10
Switch 10 14 3 16 10 2 22

Switch int switchType, int laserType, int laserSize, int state, int switchX, int switchY, int laserX, int laserY

Button int buttonType, int laserType, int buttonOneX, int buttonOneY, int buttonTwoX, int buttonTwoY, int laserX, int laserY

100 - buoy
101 - grill
200 - bronze coin
201 - silver coin
202 - gold coin
203 - Red diamond
204 - blue diamaond
300 - red door
301 - blue door