32
24
10 10 10 10 10 10 10 10 10 10 10 10 10 10 10 10 10 10 10 10 10 10 10 10 10 10 10 10 10 10 10 10 
11 202 0 0 0 0 0 0 0 0 0 0 0 0 0 0 0 0 0 0 0 0 0 0 0 0 0 0 0 0 202 11 
11 0 0 0 0 0 0 0 0 0 0 0 0 0 0 0 0 0 0 10 0 0 0 0 0 0 0 0 0 0 0 11 
11 0 0 0 0 201 0 12 3 3 3 13 0 0 0 0 0 0 0 0 0 0 0 0 0 12 10 13 0 0 0 11 
11 0 0 0 12 10 10 11 0 0 0 11 10 10 10 10 13 0 0 0 0 0 0 0 10 0 0 0 10 0 0 11 
11 13 0 0 11 0 0 0 0 0 0 0 0 0 0 0 11 0 0 0 0 0 0 10 0 0 0 0 11 0 0 11 
11 0 0 0 11 0 0 0 0 0 0 0 0 0 0 0 11 3 3 3 10 10 13 0 0 0 10 0 11 13 0 11 
11 0 0 0 11 0 0 0 12 3 3 13 0 0 0 0 0 0 0 0 0 0 0 0 0 10 0 0 11 0 0 11 
11 0 0 12 11 13 0 0 11 0 0 0 10 0 0 0 0 0 0 0 0 0 0 12 13 0 0 12 11 0 0 11 
11 0 0 0 11 0 0 0 11 0 0 0 0 12 10 10 13 0 201 0 0 12 13 0 0 0 0 11 0 0 12 11 
11 0 0 0 11 0 0 0 11 0 0 0 0 0 0 0 0 12 10 10 13 0 0 0 0 0 12 11 0 0 0 11 
11 13 0 0 11 0 0 12 11 0 0 0 0 0 0 0 0 0 0 0 0 0 0 0 0 12 11 11 13 0 0 11 
11 0 0 0 11 0 0 0 11 0 0 0 0 0 12 13 0 201 0 0 0 0 0 12 10 11 11 11 11 201 0 11 
11 0 0 0 11 0 0 0 11 0 201 0 0 0 0 0 12 10 10 10 3 3 10 11 0 0 0 0 11 13 0 11 
11 0 0 12 11 13 0 0 11 10 10 13 0 0 0 0 0 0 0 0 0 0 0 0 0 0 0 0 0 11 0 11 
11 0 0 0 11 0 0 0 0 0 0 0 12 10 13 0 0 0 0 0 12 13 0 201 0 12 10 13 0 0 0 11 
11 0 0 0 11 0 0 0 0 0 203 0 0 0 0 12 10 10 10 10 11 11 10 12 13 0 0 0 12 10 10 11 
11 13 0 0 11 10 10 13 0 0 0 0 0 0 0 0 0 0 0 0 0 0 0 0 0 0 10 0 0 0 300 11 
11 0 0 0 11 11 0 0 10 2 2 2 10 10 10 13 0 0 0 12 10 10 10 10 10 10 11 13 0 100 0 11 
11 0 0 201 11 11 0 0 0 0 0 0 0 0 0 0 12 10 13 0 0 0 0 201 0 0 0 11 10 10 10 11 
11 0 0 12 11 0 0 0 0 0 204 0 0 0 0 0 0 0 0 0 0 0 12 13 0 0 0 0 0 0 11 11 
11 0 0 0 0 0 0 0 0 0 0 0 0 0 0 0 0 0 0 0 0 12 11 11 13 0 0 0 0 0 301 11 
11 0 0 0 0 0 0 0 12 1 1 1 13 0 0 0 201 0 0 0 12 11 11 11 11 0 0 0 0 101 0 11 
11 10 10 10 10 10 10 10 11 11 11 11 11 10 10 10 10 10 10 10 11 11 11 11 11 10 10 10 10 10 10 11  
3
Switch 10 14 3 19 1 25 16
Switch 6 12 2 5 16 29 8
Button 0 4 15 1 25 6 26 5 27 6

Switch int switchType, int laserType, int laserSize, int state, int switchX, int switchY, int laserX, int laserY

Button int buttonType, int laserType, int buttonOneX, int buttonOneY, int buttonTwoX, int buttonTwoY, int laserX, int laserY

100 - buoy
101 - grill
200 - bronze coin
201 - silver coin
202 - gold coin
203 - Red diamond
204 - blue diamaond
300 - red door
301 - blue door