32
24
0 0 0 0 0 0 0 0 0 0 0 0 202 0 0 0 0 0 0 202 0 0 0 0 0 0 0 0 0 0 0 0 
0 0 0 0 0 0 0 0 0 0 0 0 0 0 0 0 0 0 0 0 0 0 0 0 0 0 0 0 0 0 0 0 
300 0 0 0 0 0 0 0 10 0 0 0 10 0 0 0 0 0 0 10 0 0 0 0 10 0 0 0 0 0 0 301 
0 0 0 0 0 0 0 0 0 0 0 0 0 0 0 12 13 0 0 0 0 0 0 0 0 0 0 0 0 0 0 0 
10 10 13 0 0 0 0 0 0 0 0 0 0 0 0 0 0 0 0 0 0 0 0 0 0 0 0 0 0 12 10 10 
0 0 0 10 0 0 0 0 0 0 0 0 0 0 0 0 0 0 0 0 0 0 0 0 0 0 0 0 10 0 0 0 
0 0 0 0 0 0 0 0 0 0 0 0 0 0 12 10 10 13 0 0 0 0 0 0 0 0 0 0 0 0 0 0 
0 0 0 0 12 13 0 0 0 0 0 0 0 0 0 0 0 0 0 0 0 0 0 0 0 12 13 0 0 0 0 0 
0 0 0 0 0 0 0 0 0 0 0 12 13 0 0 0 0 0 0 12 13 0 0 0 0 0 0 0 0 0 0 0 
0 0 0 0 0 0 0 12 13 0 0 0 0 0 0 0 0 0 0 0 0 0 12 13 0 0 0 0 0 0 0 0 
0 0 0 0 0 0 0 0 0 0 0 0 0 0 0 0 0 0 0 0 0 0 0 0 0 0 0 0 0 0 0 0 
0 0 0 0 0 0 0 0 0 0 0 0 0 12 13 0 0 12 13 0 0 0 0 0 0 0 0 0 0 0 0 0 
0 0 0 0 0 0 0 0 0 0 0 0 0 0 0 0 0 0 0 0 0 0 0 0 0 0 0 0 0 0 0 0 
0 0 0 0 0 0 0 0 0 0 0 0 0 0 0 0 0 0 0 0 0 0 0 0 0 0 0 0 0 0 0 0 
0 12 10 10 10 10 13 0 0 0 0 0 0 0 0 12 13 0 0 0 0 0 0 0 0 12 10 10 10 10 13 0 
0 0 0 0 0 0 0 0 0 12 13 0 0 0 0 0 0 0 0 0 0 12 13 0 0 0 0 0 0 0 0 0 
0 0 0 0 0 0 0 0 0 0 0 0 0 0 0 0 0 0 0 0 0 0 0 0 0 0 0 0 0 0 0 0 
10 0 0 0 0 0 0 0 0 0 0 0 12 13 0 0 0 0 12 13 0 0 0 0 0 0 0 0 0 0 0 10 
0 0 0 0 0 0 0 0 0 0 0 0 0 0 0 0 0 0 0 0 0 0 0 0 0 0 0 0 0 0 0 0 
0 0 0 0 0 0 0 0 0 12 13 0 0 0 0 12 13 0 0 0 0 12 13 0 0 0 0 0 0 0 0 0 
0 10 0 0 0 0 0 2 2 11 0 0 0 0 0 0 0 0 0 0 0 0 11 1 1 0 0 0 0 0 10 0 
203 0 0 0 0 2 2 11 11 0 0 0 12 13 0 0 0 0 12 13 0 0 0 11 11 1 1 0 0 0 0 204 
100 0 0 2 2 11 11 0 0 0 0 0 0 0 0 0 0 0 0 0 0 0 0 0 0 11 11 1 1 0 0 101 
10 2 2 11 11 0 0 0 0 0 0 0 0 0 0 12 13 0 0 0 0 0 0 0 0 0 0 11 11 1 1 10 
3
Switch 6 12 3 21 18 28 17
Switch 10 14 3 10 18 1 17
Button 2 2 13 26 11 7 19 1 3 4

Switch int switchType, int laserType, int laserSize, int state, int switchX,int switchY, int laserX, int laserY
Button int buttonOneType, int buttonTwoType, int laserType, int buttonOneX, int buttonOneY, int buttonTwoX, int buttonTwoY, int laserX, int laserY
100 - buoy
101 - grill
200 - bronze coin
201 - silver coin
202 - gold coin
203 - Red diamond
204 - blue diamond
300 - red door
301 - blue door