32
24
10 10 10 10 13 0 0 0 0 0 0 0 0 10 10 10 13 0 101 10 202 0 0 0 0 0 0 12 10 10 10 10 
0 0 0 0 11 10 13 0 0 0 0 0 0 0 0 301 11 0 12 11 0 0 0 0 0 0 0 0 0 0 0 0 
0 10 0 0 0 0 0 12 13 0 0 0 0 0 0 0 11 0 0 11 0 0 12 10 13 0 0 0 0 0 10 0 
200 0 10 0 0 0 0 0 0 10 0 0 0 12 10 10 11 0 0 11 0 0 0 0 0 0 0 0 0 10 0 200 
13 0 0 12 13 0 0 0 0 0 10 0 0 0 0 11 11 13 0 11 0 0 0 0 0 0 0 12 13 0 0 12 
0 0 0 0 0 10 0 0 0 0 11 13 0 0 0 11 11 0 0 11 0 0 0 0 0 0 10 0 0 0 0 0 
0 10 0 0 0 0 12 13 0 0 0 0 10 0 0 11 11 0 12 11 0 0 0 0 12 13 0 0 0 0 0 0 
0 0 0 0 0 0 0 0 10 0 0 0 0 10 0 0 11 0 0 0 0 0 0 10 0 0 200 0 0 0 0 0 
0 0 0 0 0 0 0 0 0 12 13 0 0 11 0 0 11 13 0 0 0 12 13 0 0 0 10 0 0 0 0 0 
0 0 12 13 0 0 0 0 0 0 0 10 0 0 0 12 11 0 0 0 10 0 0 0 0 0 0 0 0 0 0 0 
0 0 0 0 0 0 0 0 0 0 0 0 12 13 0 11 11 200 12 13 0 0 0 0 12 0 0 0 13 0 0 10 
0 0 0 0 12 10 13 0 0 12 10 0 0 0 12 11 11 13 201 11 0 10 0 12 11 0 203 0 11 2 13 11 
10 10 1 10 0 204 0 10 13 0 11 0 10 201 11 11 11 11 0 0 0 11 13 0 0 12 10 13 0 0 0 0 
11 0 0 11 0 0 0 11 0 0 0 0 11 13 200 11 11 0 12 13 0 0 0 0 0 0 0 0 0 0 0 0 
0 0 0 0 0 200 0 0 0 0 0 10 0 0 0 11 11 0 0 0 10 0 0 0 0 0 0 0 12 13 0 0 
0 0 0 0 0 10 0 0 0 12 13 0 0 0 12 11 0 0 10 0 0 12 13 0 0 0 0 0 0 0 0 0 
0 0 0 0 0 0 0 0 10 0 0 0 0 0 0 11 0 0 11 0 0 0 0 10 0 0 0 0 0 0 0 0 
13 0 0 0 0 0 12 13 0 0 0 0 12 13 0 11 13 0 201 10 0 0 0 0 12 13 0 0 0 0 12 10 
0 0 0 0 0 10 0 0 0 0 0 0 11 0 0 11 11 0 0 0 12 13 0 0 0 0 10 0 0 0 0 0 
0 0 0 12 13 0 0 0 0 0 0 0 11 0 0 11 11 0 0 0 0 11 0 0 0 0 0 12 13 0 0 0 
0 0 10 0 0 0 0 0 0 0 0 0 11 0 12 11 11 10 13 0 0 0 10 0 0 0 0 0 0 10 0 0 
0 10 0 0 0 0 0 12 10 13 0 0 11 0 0 11 300 0 0 0 0 0 0 12 13 0 0 0 0 0 10 0 
0 0 0 0 0 0 0 0 0 0 0 0 11 100 0 11 0 0 0 0 0 0 0 0 0 12 10 13 0 0 0 0 
10 10 10 10 13 3 3 3 3 3 3 3 11 10 10 11 10 10 13 3 3 3 3 3 3 3 3 11 10 10 10 10 
4
Switch 6 12 1 8 20 20 11
Switch 10 14 1 23 1 11 12
Switch 6 12 3 0 16 25 10
Switch 10 14 3 31 16 4 13

Switch int switchType, int laserType, int laserSize, int state, int switchX,int switchY, int laserX, int laserY
Button int buttonOneType, int buttonTwoType, int laserType, int buttonOneX, int buttonOneY, int buttonTwoX, int buttonTwoY, int laserX, int laserY
100 - buoy
101 - grill
200 - bronze coin
201 - silver coin
202 - gold coin
203 - Red diamond
204 - blue diamond
300 - red door
301 - blue door